11111111111111
10000001000001
11111010000001
11011010110001
11000010000001
11111000111001
10000011111101
10000001000001
11010101010101
11111111111101
